111111111111111
1E0C0000C0000C1
111000C0000P001
100001111110001
1000100C0000111
1000C1000C00CC1
100010000000111
111111111111111