1111111
1P000C1
1011101
1C000E1
1111111