11111111111111111111111111111111111111111111111111
1P0000000000000000000000000000000000000000000000C1
10111111111101111111110111111111111111110111111101
10000000000001000000000100000000000000000100000001
10111110111111101111111101111111110111010111111101
10000000100000000000000000100000000100000100000001
10111110101111111101111111101111110101111101111101
10000000100000000000100000000000000100000000000001
10111111101111111110101111111111110111111111111001
10000000000000000000100000000000000000000000000001
10111110111111111111111111101111111111111111111101
10000000100000000000000000100000000000000000000001
10111110101111111111111110101111111111111111111101
10000000100000000000000000100000000000000000000001
10111110111111111111111110101111111111111111111101
10000000000000000000000000000000000000000000000001
10111111111111111111111111101111111111111111111101
10000000000000000000000000000100000000000000000001
10111111111111111111111111110111111111111111111101
10000000000000000000000000000000000000000000000001
10111111111111111111111111111111111111111111111101
10000000000000000000000000000000000000000000000001
10111111111111111111111111111111111111111111111101
1C0000000000000000000000000000000000000000000000E1
10111111111111111111111111111111111111111111111101
10000000000000000000000000000000000000000000000001
10111111111111111111111111111111111111111111111101
10000000000000000000000000000000000000000000000001
10111111111111111111111111111111111111111111111101
10000000000000000000000000000000000000000000000001
10111111111111111111111111111111111111111111111101
10000000000000000000000000000000000000000000000001
10111111111111111111111111111111111111111111111101
10000000000000000000000000000000000000000000000001
10111111111111111111111111111111111111111111111101
10000000000000000000000000000000000000000000000001
10111111111111111111111111111111111111111111111101
10000000000000000000000000000000000000000000000001
10111111111111111111111111111111111111111111111101
10000000000000000000000000000000000000000000000001
10111111111111111111111111111111111111111111111101
10000000000000000000000000000000000000000000000001
10111111111111111111111111111111111111111111111101
10000000000000000000000000000000000000000000000001
10111111111111111111111111111111111111111111111101
1C0000000000000000000000000000000000000000000000C1
11111111111111111111111111111111111111111111111111
